S.##.....T
#E##..###.
#.###E###E
#.E...###.
###T#####G